MMMMMMMMMMMMMMMMMMMMMMMMMMMMMMMM
MPRVTTTTRRTTTTTTTTTTTTTTTTTTTTTM
MTTTTTTTTTTTTTTTTTTTTTTTTTTTRTTM
MTTTTTTTTTTTRTTTTTTTRRTTTTTRRTTM
MTTTTTTTTTTTTTTTTRTTTTTTTTTTRTTM
MTTTTTTTTTTTTTTTTTTTTTTTTTTTRTTM
MTTTTTTTTTTTTTTTTTTTTTTTTTTRRRTM
MTTTTTTTTTTTTTTTTTTTTTTTTTTTTTTM
MTTTTTTTTTTTTTTTTTTTTTTTTTTTTTTM
MTTTTTTTTTTTTTTTTTTTTTTTTTTTTTTM
MTTTTTTTTTTTTTTTTTTTTTTTTTTTTTTM
MTTTTTTTTTTTTTTTTTTTTTTTTTTTTTTM
MTTTTTTTTTTTTTTTTTTTTTTTTTTTTTTM
MTTTTTTTTTTTTTTTTTTTTTTTTTTTTTTM
MTTTTTTTTTTTTTTTTTTTTTTTTTTTTTDM
MMMMMMMMMMMMMMMMMMMMMMMMMMMMMMMM