MMMMMMMMMMMMMMMMMMMMMMMMMMMMMMMM
MTTTTTTTTTTTTTTTTTTTTTTTTTTTTRDM
MTTTTTTRTTTTTTTTTRTTTTTTTTTTRRTM
MTTTRTTTTTTTTTTTTTTTTTDTTTTTTTRM
MTTTTTTTTRDTTTTTTTTTTTTTTTTTTTTM
MTTTTTTTTTTTTTTTTTTTTTTTTTTTTTTM
MVVVVVVVMTTTRTTTTTTTTTTTTTTRDTTM
MVVVPVVVMTTTTTTTTTTDTTTTTTTTTTTM
MVVVDVVVMTTTTTTTTTTTTTTTTTRTTTTM
MVVVVVVVMTTTTTTRRTTTTTTTTTTTTTTM
MTTTTTTTTTTTTTTTRTTTTTTTTTTTTTTM
MTTTTTTTTTTTTTTTTTTTTTTTDTTTTTTM
MTTTTTTTTTTTRTTTTTTTTTTTDTTTTTTM
MTRTTTRTTTTTDTTTTTTTTTTTTTTTRTTM
MRDRTTTTTTTTTTTTTTTTTTTTTTTTTTTM
MMMMMMMMMMMMMMMMMMMMMMMMMMMMMMMM