MMMMMMMMMMMMMMMMMMMMMMMMMMMMMMMM
MPRVTTTTTTTTTTTTTTTTTTTTTTTTTTTM
MTTTTTTTTTTTTTTTTTTTTTTTTTTRRTTM
MTTTTTTTTTTTTTTTTTTTTTTTTTTTTRTM
MTTTTTTTTTTTTTTTTTTTTTTTTTTTRTTM
MTTTTTTTTTTTTTTTTTTTTTTTTTTTTRTM
MTTTTTTTTTTTTTTTTTTTTTTTTTTRRTTM
MTTTTTTTTTTTTTTTTTTTTTTTTTTTTTTM
MTTTTTTTTTTTTTTTTTTTTTTTTTTTTTTM
MTTTTTTTTTTTTTTTTTTTTTTTTTTTTTTM
MTTTTTTTTTTTTTTTTTTTTTTTTTTTTTTM
MTTTTTTTTTTTTTTTTTTTTTTTTTTTTTTM
MTTTTTTTTTTTTTTTTTTTTTTTTTTTTTTM
MTTTTTTTTTTTTTTTTTTTTTTTTTTTTTTM
MTTTTTTTTTTTTTTTTTTTTTTTTTTTTTDM
MMMMMMMMMMMMMMMMMMMMMMMMMMMMMMMM