MMMMMMMMMMMMMMMMMMMMMMMMMMMMMMMM
MPRVVRVVVRVVVRVVVRVVVRVVVRVVVVVM
MMMMVMMMVMMMVMMMVMMMVMMMVMMMMMVM
MTTTTTTTTTTTRTTTTTTTRRTTTTTTTTVM
MTTDTTTTRTTTTTTTTTTTTTTTTTTTTTVM
MTTRTTTTDTTTTTTRRTTTTTTTRTTTTTVM
MTTRTTTTTTTTTTTTTTTTTTTTTTTTTTVM
MTTTTTTTTTTRTTTTTTTRRRTTTTTTTTVM
MTTTTTTDTTTTTTTTTTTTTTTTTDTTTMVM
MTRTMMMMMMMMMMMMMMMMMMMMMMMMMMVM
MRTTTTTTTTDTTTTTTTTTTRRTTTTTTMMM
MTTTTTTTTTTTTTTTTTRTTTTTTTTTRTTM
MTTTTTTTTRRTTTTTTTTTTTTTTTTTTTTM
MTTTDTTTTTTTTTTTRTTTTTTTTTDTTTTM
MTTTTTTTTTTTTTTTTTTTTTTRTTTTTTTM
MMMMMMMMMMMMMMMMMMMMMMMMMMMMMMMM