MMMMMMMMMMMMMMMMMMMMMMMMMMMMMMMM
MRVRVRVRVRVRVRVRVRVRRRRRRRRRRRRM
MVRVRVRVRVRVRVRVRVRMTTTTMDMTTTTM
MVVVVVVVVVVVVVVVVVVMTDTTMDMTTDTM
MVVVVVVVVVVVVVVVVVVMTTTTMDMTTTTM
MVVVVVVVVVVVVVVVVVVMTTDTMDMTDTTM
MVVVVVVVVVVVVVVVVVVMTTTTTTTTTTTM
MVVVVVVVVVVVVVVVVVVMTDTTTDTTTDTM
MVVVVVVVVVVVVVVVVVVMTTTTTTTTTTTM
MVVVVVVVVVVVVVVVVVVMRRRRRRRRRRTM
MVVVVVVVVVVVVVVVVVVMTTTTTTTDTTTM
MVVVVVVVVVVVVVVVVVVMTRRRRRRRRRRM
MVVVVVVVVVVVVVVVVVVMTTTTTDTTTTTM
MVVVVVVVVVVVVVVVVVVMRRRRRRRRRRTM
MPVVVVVVVVVVVVVVVVVVTTTTTTTDTTTM
MMMMMMMMMMMMMMMMMMMMMMMMMMMMMMMM